ГБОУ ВПО "СевероЗападный ГМУ им. Мечникова" (Консультативнодиагностическая поликлиника)	Октябрьская наб., д.6 (кроме КДЦ на ул. Кирочной, д.41; Заневском пр., д.1/82)
ГБОУ ВПО "СевероЗападный ГМУ им. Мечникова" (Центр семейной медицины)	пр. Просвещения, д.45
ООО «Альянс Евразия Медицина» (Моя клиника)	ул. Гороховая, д.14/26; г. Кингисепп, Крикковское шоссе, д.9; ул. Варшавская, д.59
Поликлиническое отделение СПКК ФГУ «НМХЦ им. Н.И. Пирогова» (бывший СЗОМЦ Росздрава)	наб. реки Фонтанки, д.154; В.О., Кадетская линия, д.13/15; ул. Циолковского, д.3
ООО "Медальянс" (Клиника «Ленинский 95»)	Ленинский пр., д.95, к.1
Поликлиника ГУЗ «Городская клиническая больница № 31»	пр. Динамо, д.3, к.2
Поликлиника клинической больницы РАН	пр. Мориса Тореза, д.72
ГУЗ «Городская поликлиника № 82 (гомеопатическая)»	ул. Пражская, д.12, к.1
Клиникодиагностическое отделение ГУЗ «Городская многопрофильная больница №2»	Учебный пер., д.5
Поликлиника Военномедицинской академии им. С.М.Кирова	ул. Лебедева, д.6
ООО «Доктор»	ул. Лазо, д.5, лит.А, пом.3Н
ООО "Единый медицинский центр"	Красного текстильщика, д.15, лит.А
ООО "Здоровое Поколение"	г. Ломоносов, Петровский пер., д.1
МЦ ОАО «Адмиралтейские верфи»	ул. Садовая, д.126
МО «ОНА»	наб. реки Фонтанки, д.110; Рижская ул., д.12
МЦ «XXI век»	Б. Сампсониевский пр., д.45; ул. Марата, д.48; ул. Сикейроса, д.7, к.2; ул. Косыгина, д.34 к.1; ул. Бассейная, д.45; Коломяжский пр., д.28; Моравский пер., д.3, к.2; ул. Гастелло, д.22; ул. Пушкарская, д.20
ГУЗ «Городская поликлиника № 4»	13я линия В.О., д.16; Наличная ул., д.37
ГУЗ «Городская поликлиника № 38»	Кавалергардская ул., д.26
ГУЗ «Городская поликлиника № 40»	Невский пр., д.86
ГУЗ «Городская поликлиника № 81»	Вознесенский пр., д.19
ГУЗ «Городская поликлиника № 83»	П.С. Большой пр., д.10
Поликлиническое отделение ФГУЗ «КБ №122 им. Л.Г. Соколова ФМБА России»	пр. Культуры, д.4
Консультативнодиагностическое отделение ГУЗ «Городская больница №26»	ул. Костюшко, д.2
Консультативнодиагностическое отделение Клинической инфекционной больницы им. С.П. Боткина	ул. Миргородская, д.3/4
МЦ «Городской Консультативнодиагностический центр №1»	ул. Сикейроса, д.10
Консультативнодиагностическое отделение ГУЗ «Александровская больница»	пр. Солидарности, д.4
Консультативнодиагностическое отделение Дорожной клинической больницы ОАО «РЖД»	пр. Мечникова, д.27
Консультативнодиагностическое отделение ГУЗ «Покровская больница»	В.О., Большой пр., д.85
Травмпункт ООО «КорисАссистанс СПб»	ул. Чугунная, д.46
ООО «Институт здоровья» (Клиника позвоночника)	пр. Энгельса, д.27
ЗАО «Орланмед» (клиника «Здоровая семья»)	Коломяжский пр., д.36/2
ООО «Клиника Андрос»	ул. Ленина, д.34
Поликлиника МЦ «Одонт»	Казанская ул., д.44
Клиника «Абиа»	пр. Королева, д.48, к.7, лит. А
ООО «БалтМед гавань»	В.О. Галерный проезд, д.5
ООО «Медцентр Монблан»	ул. Зверинская, д.18
ООО «Моника» («Поэма Здоровья»)	пр. Луначарского, д.15, к.
ООО "Юнайтед МедКлиник" (сеть БалтмедГавань)	ул. Дибуновская, д.50, лит. А
ООО "Балтийская медицинская клиника"	Выборгское ш., д.5, к.1, лит. 3, пом. 55 Н
ООО «Медсервис» (Медицинский Центр «АПЕЛЬСИН»)	СтароПетергофский пр., д.39А
ООО «Немецкая клиника»	ул. Варшавская, д.23 к.1 лит. А, пом. 60 Н
МЦ «Олмед»	5я Советская ул., д.23
ООО «Центр «Академическая Медицина»	Поварской пер., д.13
ГУЗ «Женская консультация № 22»	ул. Сикейроса, 10, к.2; ул. Орбели, д.12; пр. Просвещения, д.30, к.3; Б. Сампсониевский пр., д.23
Медицинский Центр «МедЛаб»	пр. Обуховской обороны, д.71, лит. А; Фермское ш., д.32; ул. Фрунзе, д.1; пр. Славы, д.55; ул. Костюшко, д.2 (ГБ №26)
Медицинский Центр «MedSwiss» (филиал ООО «МедилюксТМ в СПб)	ул. Гаккелевская, д.21а
ЗАО «Поликлинический комплекс»	Московский пр., д.22
ФГБОУ ВПО «СанктПетербургский государственный университет» Поликлиника СПбГУ	В.О. 8я линия, д.77А; ул. Кораблестроителей, д. 20; г. Петродворец, Университетский пр., д. 35
ООО «Медиус и К» (с вызовом врача на дом)	г. Всеволожск, ул. Социалистическая, д.107
ООО «ИНФАНТРЕГИОН»	г. Всеволожск, Октябрьский пр., д.122, лит. А
ООО «Медицинский Дом»	г. Всеволожск, Александровская, д.80, лит.А
ООО «СМС «СтомаМедСервис»	г. Гатчина, пр. 25 Октября, д.16, 22, 32
ООО «Медиком » (с вызовом врача на дом)	г. Гатчина, ул. Киргетова, д.6а
ООО «Клиника «Медиком» (с вызовом врача на дом)	г. Гатчина, ул.7ой Армии, д.10а
ООО «Медиком» (с вызовом врача на дом)	г. Гатчина, ул. Зверевой, д.1а
ООО «Европейский институт здоровья семьи»	г. Колпино, бр Трудящихся, д.35, к.1;г. Пушкин, ул. Вячеслава Шишкова, д.28/3, оф.1
АНО «МЦ «Мир здоровья» (с вызовом врача на дом)	г. Колпино, ул. Машиностроителей, д.10
ООО «ЛДЦ «Оника»	г. Пушкин, ул. Школьная, д.23
ООО «Медицинский центр «Здоровье»	г. Тосно, Московское шоссе, д.40
ООО «ЕвроМед Клиник»	Суворовский пр., д.60
НИЛЦ «Деома» (Клиника имени Пирогова)	В.О., Большой пр., д.51/17
ООО "ММЦ Медикал Он груп  СПб"	ул. Жуковского, д.79; Богатырский пр. д. 25, к.1; пр. Ветеранов, д.52, к.1
МСЧ № 157	ул. Варшавская, д.100
НПП «Иммунобиосервис»	Московское шоссе, д.30, к.2
ООО «Медильер»	ул. Б. Разночинная, д.30
ФГУЗ «Всероссийский Центр экстренной и радиационной медицины МЧС России»	ул. Лебедева, д.4/2; ул. Оптиков, д.54
ООО «ЕМС»	ул. Победы, д.17
Поликлиническое отделение Оздоровительного учреждения "Лечебно диагностический центр Международного института биологических систем" (ЛДЦ "МИБС")	6я Советская, д.2426/1921
ООО "Клиника доктора Пеля"	В.О., 7я линия, д.1618
ООО МЦ «Надежда» (Клиника Медпросвет)	пр. Энгельса д.147 корп.1
ЗАО "Промед Плюс"	ул. Литовская, д.8, к.2, лит.А
ООО «Меди ком» (СМклиника)	пр. Ударников, д.19, к.1
МЦ «Прайм Роуз»	ул. Савушкина, д.115, к.4
Городская больница № 25 (Городской ревматологический центр)	Большая Подьяческая ул., д.30
ФГУ «Федеральный центр сердца, крови и эндокринологии им. В.А. Алмазова» Росмедтехнологий	ул. Аккуратова, 2; пр. Пархоменко, д.15 (реабилитационный центр)
Институт мозга человека РАН	ул. Академика Павлова, д12
ГБОУ ВПО "СевероЗападный ГМУ им. Мечникова"	СантьягодеКуба, д.1/28;ул. Кирочная, д.41; Заневский пр., д.1; ул. СантьягодеКуба, д.1/28
Лечебнодиагностический центр МИБС	Удельный пр., д.22а; ул. Костюшко, д.2; Приморский пр., д.3; ул. 6я Советская, д.2426
Городской онкологический диспансер	2я Березовая аллея, д.3/5; пр. Ветеранов, д.56
ООО «Центр МРТ «ОНА»	пр. Ветеранов, д.56
ЗАО «Центр Флебологии»	ул. Комсомола, д.14; Невский пр., д.111
Центр лучевой диагностики «Медика»	пр. Мориса Тореза, д.72
ГУ СанктПетербургский научноисследовательский психоневрологический институт им. В.М. Бехтерева	ул. Бехтерева, д.3
OOO "НПФ "Хеликс"	(все действующие адреса)
ЗАО "Ситилаб"	ул. Бухарестская, д.134
ООО "ЛабТест"	ул. Минеральная, д.13А
ООО "ДЦ "Энерго"	пр. Энгельса, д.33 к.1
Центр превентивной медицины ассоциации онкологовгинекологов	Набережная р. Фонтанки, д.127
ООО «МРТ»	16 линия В.О., д.81, лит. А
Медикогенетический центр (диагностический)	ул. Тобольская, д.5
СПБ филиал ГУ МНТК «Микрохирургии глаза»	ул. Ярослава Гашека, д.21
НИИ акушерства и гинекологии им. Д.О. Отта	Менделеевская линия, д.3
НИИ уха, горла, носа и речи (ЛОР – НИИ)	Бронницкая ул., д.9
НИИ скорой помощи им. И. И. Джанелидзе	ул. Будапештская, д.3
Российский НИИ травматологии и ортопедии им. Р.Р. Вредена	ул. Академика Байкова, д.8
ГУЗ Центр планирования семьи и репродукции	ул. Комсомола, д.4	